$ANSIBLE_VAULT;1.1;AES256
32653530646532643166396462396262303236306537346333333566313633616239386661613833
6535323063623766343563616337303162303731333462340a346563643465373666333465383763
61383537336265363334366435363065393661653232653236393231323863386666343230613163
3861323437383230380a613034653031393363613663393036343130636330663761306233393062
30373264653132356539343965346136626532326464613736643739663138643163396330383630
37333234316136336337383036386430343365633434613236343462353033383463306633646536
66343930623935336165623861613565343233363537393636303135623837346432333861616264
31363961326530303766663831373266373231663732303138653165383431653333646539313165
37323864623535653034653262326436333265383965643765353764613236653930356130383935
30656631653333613963393135363234363761653531306436633165663961393039313066323661
30353561353038336134363062356536356262366266363538326538643739613935393639313065
62373631363938613266323432363339666237336465333337393962306634356666386330343036
63633238356531313663323164303161333539316261343161306638613537333861343866623832
63646237633137373264323533613566616664666162626632346363336437356630353862336438
34656333333930356531666162636431636231653533396233616531656532666561343233323266
36623336656666653363356437386139623565356535646562353362646432396662343065356330
66653032643665376230383263323665353731313538353332323363666665363136666136383362
38343630376162626436663531343336643564636266343365383737346436333633623336643833
38373764643437643765376435393462393432396334663766646164356162353134363139396264
30316130623039326630323930323161663036336365353630336238393033666438626533636631
39636533656563653763633030653134616232666432393839343430303061373830323939643538
63313862643635633332656332306530396561393537626565303166396662386239633536346361
30643431333466346265613333613865313630316362643461316363383537323834616632393666
31343961663563363662303061613766396665323961643430633261656135383036366237643638
33626564623362396638633664643036663132653662346132646331643563326337613534353764
62633734616333346231373665353138326265376234646530323536343532373237343232316666
63613163363839363736663030336562623132613864393636326432353235356562363436636133
37323663383231316135646438623764366539343733383934623730333166643331326135646532
62303737333965643133366234373766663534343065383464306362343938366539623464396135
65623837333762633936323266383464626332396361633834383764323766626438653135323937
31383135383461613262616131336364363632343031366336366232656139663133616239353936
39353164623433366136346534383836326466633930316539623266616638363136336162333132
66356539363665333263316534366262396633393864633630336630336661616265376164353363
63633261303630373430626432373636346630613663616632663566363661333463303136303336
33336264643866666138386539333732613836613236643333333834626536306138353535663333
36306362656530323431633531656465303964313761303433383236333964363831626331623165
61366236383631663564376637356661313861623635633732646561666432363565336337333638
34366134366432323263363732626163303866303862363634383032353662333465383361643565
333763323966313037336362363536616332
